#####################
#  ##UP  UP##      ##
#  ##############  ##
#UP##        UP    ##
#####  ##########  ##
#  ##          ##CH##
#  ##########  ######
#UP  UP##  ##      ##
#########  ######  ##
#UP  UP##UP  UP##UP##
#####################
#####################
#    DW##DW        ##
#  ##############  ##
#DW##        DW##  ##
#####  ##########  ##
#      ##      ##  ##
#  ######  ##  ##  ##
#DW##DW    ##  ##  ##
#############  ##  ##
#DW##DW  DW##DW##DW##
#####################
